NO       ./textures/walls/wall_01.xpm
SO       ./textures/walls/wall_02.xpm
EA       ./textures/walls/wall_03.xpm
WE       ./textures/walls/wall_04.xpm



F        108  , 115 , 122

C        171  , 205 , 239 

11111111111111   1111111111111111
100000001000001 11011001000000101
1111111111011001101110011111111001
11111111100010000000000000000000001
1111111110110000111000000000000011
101000000011000001110111110111111
11110111111111011100000010001
1111011111111101 101010010001
1100000011010101 100000010001
1100000111010101 111011110N0111
11110111 1110101 101111010101
11111111 1111111 1111111111111