NO     ./textures/wall40x40.xpm

SO ./textures/wall40x40.xpm

WE ./textures/wall40x40.xpm
EA       ./textures/wall40x40.xpm

F 171  , 205 , 239

C 225,30,0

        111111   1111111111111111
        1000001 11011001000000101
        1011000101110011111111001
        1001000000000000000000001
111111111011000001110000000000001
101000000011000001110111110111111
11110111111111011100000010001
1111011111111101 101010010001
1100000011010101 100000010001
1100000111010101 11101111000111
11110111 1110101 1011110101N1
11111111 1111111 111111111111